..>>v>vv.v
..v.>>vv..
v.>>v>>v..
..>>>>>vv.
vvv....>vv
..v....>>>
v>.......>
.vv>....v>
.>v.vv.v..

