..>>v>vv..
..v.>>vv..
..>>v>>vv.
..>>>>>vv.
v......>vv
v>v....>>v
vvv.....>>
>vv......>
.>v.vv.v..

