v>.....>>.
>vv>.....v
.>v>v.vv>>
v>>>v.>v.>
....vv>v..
.v.>>>vvv.
..v..>>vv.
v.v...>>.v
..v.....v>

