vv>...>v>.
v.v.v>.>v.
>.v.>.>.>v
>v>.>..v>>
..v>v.v...
..>.>>vvv.
.>...v>v..
..v.v>>v.v
v.v.>...v.

