....>.>v.>
v.v>.>v.v.
>v>>..>v..
>>v>v>.>.v
.>v.v...v.
v>>.>vvv..
..v...>>..
vv...>>vv.
>.v.v..v.v

